Detector,Profile,File,Threshold,Score,TP,TN,FP,FN,Total_Count
Variable50,reward_low_FP_rate,realAWSCloudwatch/ec2_disk_write_bytes_c0d644.csv,0.590052437310731,2.53219629560726,108,3020,3,297,3428
Variable50,reward_low_FP_rate,realAWSCloudwatch/ec2_cpu_utilization_fe7f93.csv,0.590052437310731,2.4709312668523604,133,3020,3,272,3428
Variable50,reward_low_FP_rate,realAWSCloudwatch/ec2_cpu_utilization_24ae8d.csv,0.590052437310731,1.7728782024912402,117,3024,2,285,3428
Variable50,reward_low_FP_rate,realAWSCloudwatch/ec2_cpu_utilization_53ea38.csv,0.590052437310731,1.991308043268138,294,3024,2,108,3428
Variable50,reward_low_FP_rate,realAWSCloudwatch/ec2_cpu_utilization_77c1ca.csv,0.590052437310731,0.16638693072837263,196,3021,4,207,3428
Variable50,reward_low_FP_rate,realAWSCloudwatch/elb_request_count_8c0756.csv,0.590052437310731,1.7724129947920133,396,3023,3,6,3428
Variable50,reward_low_FP_rate,realAWSCloudwatch/ec2_network_in_257a54.csv,0.590052437310731,0.9979464088886466,399,3024,1,4,3428
Variable50,reward_low_FP_rate,realAWSCloudwatch/ec2_cpu_utilization_c6585a.csv,0.590052437310731,-0.22,0,3427,1,0,3428
Variable50,reward_low_FP_rate,realAWSCloudwatch/ec2_cpu_utilization_825cc2.csv,0.590052437310731,0.997789593505199,278,3084,1,65,3428
Variable50,reward_low_FP_rate,realAWSCloudwatch/ec2_network_in_5abac7.csv,0.590052437310731,1.9932731050718693,458,3545,2,16,4021
Variable50,reward_low_FP_rate,realAWSCloudwatch/iio_us-east-1_i-a2eb1cd9_NetworkIn.csv,0.590052437310731,1.9722222130101321,118,929,2,8,1057
Variable50,reward_low_FP_rate,realAWSCloudwatch/grok_asg_anomaly.csv,0.590052437310731,2.7617689485903374,243,3460,3,222,3928
Variable50,reward_low_FP_rate,realAWSCloudwatch/ec2_cpu_utilization_ac20cd.csv,0.590052437310731,0.9979464088886466,281,3024,1,122,3428
Variable50,reward_low_FP_rate,realAWSCloudwatch/ec2_disk_write_bytes_1ef3de.csv,0.590052437310731,0.32998042623181445,94,3545,3,379,4021
Variable50,reward_low_FP_rate,realAWSCloudwatch/rds_cpu_utilization_e47b3b.csv,0.590052437310731,1.9897732406658317,350,3024,2,52,3428
Variable50,reward_low_FP_rate,realAWSCloudwatch/rds_cpu_utilization_cc0c53.csv,0.590052437310731,1.9920476987155755,375,3024,2,27,3428
Variable50,reward_low_FP_rate,realAWSCloudwatch/ec2_cpu_utilization_5f5533.csv,0.590052437310731,1.991308043268138,383,3024,2,19,3428
Variable50,reward_low_FP_rate,realTraffic/TravelTime_387.csv,0.590052437310731,2.5318864784253527,240,1871,5,9,2125
Variable50,reward_low_FP_rate,realTraffic/TravelTime_451.csv,0.590052437310731,0.9964897719939371,214,1620,1,3,1838
Variable50,reward_low_FP_rate,realTraffic/speed_t4013.csv,0.590052437310731,1.9876967397457337,228,1869,2,22,2121
Variable50,reward_low_FP_rate,realTraffic/speed_7578.csv,0.590052437310731,3.8676912810680575,100,838,4,16,958
Variable50,reward_low_FP_rate,realTraffic/occupancy_6005.csv,0.590052437310731,0.7766326774704889,224,1782,2,15,2023
Variable50,reward_low_FP_rate,realTraffic/speed_6005.csv,0.590052437310731,0.9988244156473273,235,1886,0,4,2125
Variable50,reward_low_FP_rate,realTraffic/occupancy_t4013.csv,0.590052437310731,1.9876967397457337,241,1873,2,9,2125
Variable50,reward_low_FP_rate,artificialWithAnomaly/art_increase_spike_density.csv,0.590052437310731,0.9993145504551451,48,3025,0,355,3428
Variable50,reward_low_FP_rate,artificialWithAnomaly/art_daily_jumpsup.csv,0.590052437310731,0.9981209291721,395,3024,1,8,3428
Variable50,reward_low_FP_rate,artificialWithAnomaly/art_load_balancer_spikes.csv,0.590052437310731,0.7341228609573202,184,3022,3,219,3428
Variable50,reward_low_FP_rate,artificialWithAnomaly/art_daily_jumpsdown.csv,0.590052437310731,0.7781209291721001,396,3023,2,7,3428
Variable50,reward_low_FP_rate,artificialWithAnomaly/art_daily_flatmiddle.csv,0.590052437310731,0.7779464088886465,384,3023,2,19,3428
Variable50,reward_low_FP_rate,artificialWithAnomaly/art_daily_nojump.csv,0.590052437310731,0.7781209291721001,400,3023,2,3,3428
Variable50,reward_low_FP_rate,realAdExchange/exchange-2_cpm_results.csv,0.590052437310731,1.9786555230600862,125,1217,2,37,1381
Variable50,reward_low_FP_rate,realAdExchange/exchange-4_cpm_results.csv,0.590052437310731,3.7506328310082484,38,1232,1,126,1397
Variable50,reward_low_FP_rate,realAdExchange/exchange-3_cpm_results.csv,0.590052437310731,0.7786127948543187,62,1154,1,91,1308
Variable50,reward_low_FP_rate,realAdExchange/exchange-3_cpc_results.csv,0.590052437310731,2.956627969306448,101,1153,2,52,1308
Variable50,reward_low_FP_rate,realAdExchange/exchange-4_cpc_results.csv,0.590052437310731,2.4946443594501826,43,1229,3,122,1397
Variable50,reward_low_FP_rate,realAdExchange/exchange-2_cpc_results.csv,0.590052437310731,0.9948474596381942,118,1217,1,45,1381
Variable50,reward_low_FP_rate,artificialNoAnomaly/art_daily_perfect_square_wave.csv,0.590052437310731,0.0,0,3428,0,0,3428
Variable50,reward_low_FP_rate,artificialNoAnomaly/art_daily_no_noise.csv,0.590052437310731,-0.22,0,3427,1,0,3428
Variable50,reward_low_FP_rate,artificialNoAnomaly/art_flatline.csv,0.590052437310731,0.0,0,3428,0,0,3428
Variable50,reward_low_FP_rate,artificialNoAnomaly/art_noisy.csv,0.590052437310731,0.0,0,3428,0,0,3428
Variable50,reward_low_FP_rate,artificialNoAnomaly/art_daily_small_noise.csv,0.590052437310731,-0.22,0,3427,1,0,3428
Variable50,reward_low_FP_rate,realTweets/Twitter_volume_IBM.csv,0.590052437310731,0.8977532094464193,1310,13546,7,280,15143
Variable50,reward_low_FP_rate,realTweets/Twitter_volume_CVS.csv,0.590052437310731,2.334417862986916,787,13572,5,739,15103
Variable50,reward_low_FP_rate,realTweets/Twitter_volume_FB.csv,0.590052437310731,1.9979175371211233,1574,13499,2,8,15083
Variable50,reward_low_FP_rate,realTweets/Twitter_volume_PFE.csv,0.590052437310731,3.107239142434381,1188,13511,9,400,15108
Variable50,reward_low_FP_rate,realTweets/Twitter_volume_AAPL.csv,0.590052437310731,3.5494151814391746,1574,13557,7,14,15152
Variable50,reward_low_FP_rate,realTweets/Twitter_volume_GOOG.csv,0.590052437310731,2.552045797965958,1422,13654,6,10,15092
Variable50,reward_low_FP_rate,realTweets/Twitter_volume_CRM.csv,0.590052437310731,2.9924586611724027,1350,13555,4,243,15152
Variable50,reward_low_FP_rate,realTweets/Twitter_volume_UPS.csv,0.590052437310731,3.8142357295719327,924,13522,9,661,15116
Variable50,reward_low_FP_rate,realTweets/Twitter_volume_KO.csv,0.590052437310731,2.554283592542161,1576,13508,6,11,15101
Variable50,reward_low_FP_rate,realTweets/Twitter_volume_AMZN.csv,0.590052437310731,3.7690040732597745,1565,13495,6,15,15081
Variable50,reward_low_FP_rate,realKnownCause/ambient_temperature_system_failure.csv,0.590052437310731,1.9956299348583362,707,5789,2,19,6517
Variable50,reward_low_FP_rate,realKnownCause/machine_temperature_system_failure.csv,0.590052437310731,3.9945457279202063,2241,19673,4,27,21945
Variable50,reward_low_FP_rate,realKnownCause/ec2_request_latency_system_failure.csv,0.590052437310731,2.980359975774524,241,3080,2,105,3428
Variable50,reward_low_FP_rate,realKnownCause/cpu_utilization_asg_misconfiguration.csv,0.590052437310731,-0.3203183135078933,1466,15795,6,33,17300
Variable50,reward_low_FP_rate,realKnownCause/rogue_agent_key_hold.csv,0.590052437310731,1.7619495014220905,180,1407,3,10,1600
Variable50,reward_low_FP_rate,realKnownCause/nyc_taxi.csv,0.590052437310731,4.975897046398089,1019,8529,6,16,9570
Variable50,reward_low_FP_rate,realKnownCause/rogue_agent_key_updown.csv,0.590052437310731,1.0166679726268404,22,4031,4,508,4565
Totals,,,,101.21035810323954,27145,299184,163,6350,332842
