Detector,Profile,File,Threshold,Score,TP,TN,FP,FN,Total_Count
Fixed10,reward_low_FP_rate,realAWSCloudwatch/ec2_cpu_utilization_ac20cd.csv,0.6472191863106423,0.9975908984951469,252,3024,1,151,3428
Fixed10,reward_low_FP_rate,realAWSCloudwatch/ec2_disk_write_bytes_c0d644.csv,0.6472191863106423,0.7736071412253565,113,3021,2,292,3428
Fixed10,reward_low_FP_rate,realAWSCloudwatch/rds_cpu_utilization_cc0c53.csv,0.6472191863106423,1.9920476987155755,365,3024,2,37,3428
Fixed10,reward_low_FP_rate,realAWSCloudwatch/ec2_network_in_257a54.csv,0.6472191863106423,0.9982933272758095,401,3024,1,2,3428
Fixed10,reward_low_FP_rate,realAWSCloudwatch/ec2_cpu_utilization_5f5533.csv,0.6472191863106423,1.9909243992600176,338,3024,2,64,3428
Fixed10,reward_low_FP_rate,realAWSCloudwatch/grok_asg_anomaly.csv,0.6472191863106423,2.981768682428945,234,3461,2,231,3928
Fixed10,reward_low_FP_rate,realAWSCloudwatch/rds_cpu_utilization_e47b3b.csv,0.6472191863106423,1.9872011982278304,336,3024,2,66,3428
Fixed10,reward_low_FP_rate,realAWSCloudwatch/iio_us-east-1_i-a2eb1cd9_NetworkIn.csv,0.6472191863106423,1.9763357064410605,120,929,2,6,1057
Fixed10,reward_low_FP_rate,realAWSCloudwatch/ec2_cpu_utilization_c6585a.csv,0.6472191863106423,0.0,0,3428,0,0,3428
Fixed10,reward_low_FP_rate,realAWSCloudwatch/ec2_network_in_5abac7.csv,0.6472191863106423,1.9935726056887946,393,3545,2,81,4021
Fixed10,reward_low_FP_rate,realAWSCloudwatch/ec2_cpu_utilization_825cc2.csv,0.6472191863106423,0.99799323589984,247,3084,1,96,3428
Fixed10,reward_low_FP_rate,realAWSCloudwatch/ec2_disk_write_bytes_1ef3de.csv,0.6472191863106423,0.759522622263543,82,3547,1,391,4021
Fixed10,reward_low_FP_rate,realAWSCloudwatch/ec2_cpu_utilization_fe7f93.csv,0.6472191863106423,2.5749705190707957,95,3022,1,310,3428
Fixed10,reward_low_FP_rate,realAWSCloudwatch/elb_request_count_8c0756.csv,0.6472191863106423,1.7731258928110845,398,3023,3,4,3428
Fixed10,reward_low_FP_rate,realAWSCloudwatch/ec2_cpu_utilization_24ae8d.csv,0.6472191863106423,1.9925038431202404,91,3025,1,311,3428
Fixed10,reward_low_FP_rate,realAWSCloudwatch/ec2_cpu_utilization_53ea38.csv,0.6472191863106423,1.991673339344576,204,3024,2,198,3428
Fixed10,reward_low_FP_rate,realAWSCloudwatch/ec2_cpu_utilization_77c1ca.csv,0.6472191863106423,0.9993145504551451,137,3025,0,266,3428
Fixed10,reward_low_FP_rate,realTraffic/speed_6005.csv,0.6472191863106423,0.999127466332713,236,1886,0,3,2125
Fixed10,reward_low_FP_rate,realTraffic/speed_7578.csv,0.6472191863106423,3.8660185519168944,87,838,4,29,958
Fixed10,reward_low_FP_rate,realTraffic/occupancy_6005.csv,0.6472191863106423,0.9949010055693926,162,1783,1,77,2023
Fixed10,reward_low_FP_rate,realTraffic/TravelTime_451.csv,0.6472191863106423,0.9968184488353512,215,1620,1,2,1838
Fixed10,reward_low_FP_rate,realTraffic/occupancy_t4013.csv,0.6472191863106423,1.9876967397457337,227,1873,2,23,2125
Fixed10,reward_low_FP_rate,realTraffic/speed_t4013.csv,0.6472191863106423,1.9882916935449881,175,1869,2,75,2121
Fixed10,reward_low_FP_rate,realTraffic/TravelTime_387.csv,0.6472191863106423,2.7537702284934444,242,1872,4,7,2125
Fixed10,reward_low_FP_rate,artificialWithAnomaly/art_daily_jumpsup.csv,0.6472191863106423,0.9981209291721,387,3024,1,16,3428
Fixed10,reward_low_FP_rate,artificialWithAnomaly/art_daily_nojump.csv,0.6472191863106423,0.9982933272758095,401,3024,1,2,3428
Fixed10,reward_low_FP_rate,artificialWithAnomaly/art_daily_flatmiddle.csv,0.6472191863106423,0.9989590400616454,228,3025,0,175,3428
Fixed10,reward_low_FP_rate,artificialWithAnomaly/art_load_balancer_spikes.csv,0.6472191863106423,0.9554910025238186,140,3024,1,263,3428
Fixed10,reward_low_FP_rate,artificialWithAnomaly/art_daily_jumpsdown.csv,0.6472191863106423,0.9981209291721,394,3024,1,9,3428
Fixed10,reward_low_FP_rate,artificialWithAnomaly/art_increase_spike_density.csv,0.6472191863106423,0.9993145504551451,44,3025,0,359,3428
Fixed10,reward_low_FP_rate,realAdExchange/exchange-2_cpc_results.csv,0.6472191863106423,0.9982422518813143,89,1218,0,74,1381
Fixed10,reward_low_FP_rate,realAdExchange/exchange-4_cpc_results.csv,0.6472191863106423,2.7399970885489533,28,1232,0,137,1397
Fixed10,reward_low_FP_rate,realAdExchange/exchange-3_cpc_results.csv,0.6472191863106423,2.912231460359399,55,1154,1,98,1308
Fixed10,reward_low_FP_rate,realAdExchange/exchange-3_cpm_results.csv,0.6472191863106423,0.9986127948543186,45,1155,0,108,1308
Fixed10,reward_low_FP_rate,realAdExchange/exchange-4_cpm_results.csv,0.6472191863106423,3.838917814365292,23,1232,1,141,1397
Fixed10,reward_low_FP_rate,realAdExchange/exchange-2_cpm_results.csv,0.6472191863106423,1.976258898682598,101,1217,2,61,1381
Fixed10,reward_low_FP_rate,artificialNoAnomaly/art_daily_small_noise.csv,0.6472191863106423,0.0,0,3428,0,0,3428
Fixed10,reward_low_FP_rate,artificialNoAnomaly/art_noisy.csv,0.6472191863106423,0.0,0,3428,0,0,3428
Fixed10,reward_low_FP_rate,artificialNoAnomaly/art_flatline.csv,0.6472191863106423,0.0,0,3428,0,0,3428
Fixed10,reward_low_FP_rate,artificialNoAnomaly/art_daily_perfect_square_wave.csv,0.6472191863106423,0.0,0,3428,0,0,3428
Fixed10,reward_low_FP_rate,artificialNoAnomaly/art_daily_no_noise.csv,0.6472191863106423,0.0,0,3428,0,0,3428
Fixed10,reward_low_FP_rate,realTweets/Twitter_volume_AMZN.csv,0.6472191863106423,3.7726824272514783,1568,13496,5,12,15081
Fixed10,reward_low_FP_rate,realTweets/Twitter_volume_FB.csv,0.6472191863106423,1.9979175371211233,1561,13499,2,21,15083
Fixed10,reward_low_FP_rate,realTweets/Twitter_volume_UPS.csv,0.6472191863106423,4.899318758279899,733,13528,3,852,15116
Fixed10,reward_low_FP_rate,realTweets/Twitter_volume_CVS.csv,0.6472191863106423,2.9931477806040396,394,13575,2,1132,15103
Fixed10,reward_low_FP_rate,realTweets/Twitter_volume_GOOG.csv,0.6472191863106423,2.9951083773832288,1419,13657,3,13,15092
Fixed10,reward_low_FP_rate,realTweets/Twitter_volume_AAPL.csv,0.6472191863106423,3.992367146649117,1576,13560,4,12,15152
Fixed10,reward_low_FP_rate,realTweets/Twitter_volume_IBM.csv,0.6472191863106423,1.3371316013305565,1016,13548,5,574,15143
Fixed10,reward_low_FP_rate,realTweets/Twitter_volume_KO.csv,0.6472191863106423,2.775842826171349,1557,13510,4,30,15101
Fixed10,reward_low_FP_rate,realTweets/Twitter_volume_CRM.csv,0.6472191863106423,2.9923799714411574,1039,13556,3,554,15152
Fixed10,reward_low_FP_rate,realTweets/Twitter_volume_PFE.csv,0.6472191863106423,3.9864659322349296,729,13516,4,859,15108
Fixed10,reward_low_FP_rate,realKnownCause/cpu_utilization_asg_misconfiguration.csv,0.6472191863106423,0.7796356117173272,1161,15800,1,338,17300
Fixed10,reward_low_FP_rate,realKnownCause/nyc_taxi.csv,0.6472191863106423,4.98193513234036,1021,8530,5,14,9570
Fixed10,reward_low_FP_rate,realKnownCause/ambient_temperature_system_failure.csv,0.6472191863106423,1.9958246025858082,670,5789,2,56,6517
Fixed10,reward_low_FP_rate,realKnownCause/ec2_request_latency_system_failure.csv,0.6472191863106423,2.9690314862194875,181,3080,2,165,3428
Fixed10,reward_low_FP_rate,realKnownCause/machine_temperature_system_failure.csv,0.6472191863106423,3.9958818138718595,2249,19674,3,19,21945
Fixed10,reward_low_FP_rate,realKnownCause/rogue_agent_key_updown.csv,0.6472191863106423,1.2366679726268401,20,4032,3,510,4565
Fixed10,reward_low_FP_rate,realKnownCause/rogue_agent_key_hold.csv,0.6472191863106423,1.7589670241676147,151,1407,3,39,1600
Totals,,,,109.23993588451094,24130,299246,101,9365,332842
