Detector,Profile,File,Threshold,Score,TP,TN,FP,FN,Total_Count
Fixed10,reward_low_FN_rate,realAWSCloudwatch/ec2_cpu_utilization_ac20cd.csv,0.5724117801133384,0.9986304796718958,289,3024,1,114,3428
Fixed10,reward_low_FN_rate,realAWSCloudwatch/ec2_disk_write_bytes_c0d644.csv,0.5724117801133384,2.8841752794165854,119,3021,2,286,3428
Fixed10,reward_low_FN_rate,realAWSCloudwatch/rds_cpu_utilization_cc0c53.csv,0.5724117801133384,1.9955193005813334,378,3024,2,24,3428
Fixed10,reward_low_FN_rate,realAWSCloudwatch/ec2_network_in_257a54.csv,0.5724117801133384,0.9989773980590587,401,3024,1,2,3428
Fixed10,reward_low_FN_rate,realAWSCloudwatch/ec2_cpu_utilization_5f5533.csv,0.5724117801133384,1.995875749590869,383,3024,2,19,3428
Fixed10,reward_low_FN_rate,realAWSCloudwatch/grok_asg_anomaly.csv,0.5724117801133384,2.992308368058733,250,3461,2,215,3928
Fixed10,reward_low_FN_rate,realAWSCloudwatch/rds_cpu_utilization_e47b3b.csv,0.5724117801133384,1.9951540045048957,356,3024,2,46,3428
Fixed10,reward_low_FN_rate,realAWSCloudwatch/iio_us-east-1_i-a2eb1cd9_NetworkIn.csv,0.5724117801133384,1.9865026674870174,121,929,2,5,1057
Fixed10,reward_low_FN_rate,realAWSCloudwatch/ec2_cpu_utilization_c6585a.csv,0.5724117801133384,-0.11,0,3427,1,0,3428
Fixed10,reward_low_FN_rate,realAWSCloudwatch/ec2_network_in_5abac7.csv,0.5724117801133384,1.9959030269935907,459,3545,2,15,4021
Fixed10,reward_low_FN_rate,realAWSCloudwatch/ec2_cpu_utilization_825cc2.csv,0.5724117801133384,0.9987973151450854,277,3084,1,66,3428
Fixed10,reward_low_FN_rate,realAWSCloudwatch/ec2_disk_write_bytes_1ef3de.csv,0.5724117801133384,0.8709094267654898,102,3547,1,371,4021
Fixed10,reward_low_FN_rate,realAWSCloudwatch/ec2_cpu_utilization_fe7f93.csv,0.5724117801133384,2.981919340090975,162,3022,1,243,3428
Fixed10,reward_low_FN_rate,realAWSCloudwatch/elb_request_count_8c0756.csv,0.5724117801133384,1.885875749590869,398,3023,3,4,3428
Fixed10,reward_low_FN_rate,realAWSCloudwatch/ec2_cpu_utilization_24ae8d.csv,0.5724117801133384,1.9961545735237882,138,3025,1,264,3428
Fixed10,reward_low_FN_rate,realAWSCloudwatch/ec2_cpu_utilization_53ea38.csv,0.5724117801133384,1.9951628515717978,288,3024,2,114,3428
Fixed10,reward_low_FN_rate,realAWSCloudwatch/ec2_cpu_utilization_77c1ca.csv,0.5724117801133384,0.9993145504551451,259,3025,0,144,3428
Fixed10,reward_low_FN_rate,realTraffic/speed_6005.csv,0.5724117801133384,0.999127466332713,236,1886,0,3,2125
Fixed10,reward_low_FN_rate,realTraffic/speed_7578.csv,0.5724117801133384,3.931575633368789,105,838,4,11,958
Fixed10,reward_low_FN_rate,realTraffic/occupancy_6005.csv,0.5724117801133384,0.9982689116860279,227,1783,1,12,2023
Fixed10,reward_low_FN_rate,realTraffic/TravelTime_451.csv,0.5724117801133384,0.9980915401365803,215,1620,1,2,1838
Fixed10,reward_low_FN_rate,realTraffic/occupancy_t4013.csv,0.5724117801133384,1.992726576538666,243,1873,2,7,2125
Fixed10,reward_low_FN_rate,realTraffic/speed_t4013.csv,0.5724117801133384,1.992726576538666,225,1869,2,25,2121
Fixed10,reward_low_FN_rate,realTraffic/TravelTime_387.csv,0.5724117801133384,2.874769963049253,243,1872,4,6,2125
Fixed10,reward_low_FN_rate,artificialWithAnomaly/art_daily_jumpsup.csv,0.5724117801133384,0.9989773980590587,400,3024,1,3,3428
Fixed10,reward_low_FN_rate,artificialWithAnomaly/art_daily_nojump.csv,0.5724117801133384,0.9989773980590587,401,3024,1,2,3428
Fixed10,reward_low_FN_rate,artificialWithAnomaly/art_daily_flatmiddle.csv,0.5724117801133384,0.9986304796718958,388,3024,1,15,3428
Fixed10,reward_low_FN_rate,artificialWithAnomaly/art_load_balancer_spikes.csv,0.5724117801133384,0.9568590911811462,179,3024,1,224,3428
Fixed10,reward_low_FN_rate,artificialWithAnomaly/art_daily_jumpsdown.csv,0.5724117801133384,0.9989773980590587,398,3024,1,5,3428
Fixed10,reward_low_FN_rate,artificialWithAnomaly/art_increase_spike_density.csv,0.5724117801133384,0.9994890707385985,50,3025,0,353,3428
Fixed10,reward_low_FN_rate,realAdExchange/exchange-2_cpc_results.csv,0.5724117801133384,0.9965448557597543,120,1217,1,43,1381
Fixed10,reward_low_FN_rate,realAdExchange/exchange-4_cpc_results.csv,0.5724117801133384,2.8668018760192684,52,1230,2,113,1397
Fixed10,reward_low_FN_rate,realAdExchange/exchange-3_cpc_results.csv,0.5724117801133384,2.975046130814313,107,1153,2,46,1308
Fixed10,reward_low_FN_rate,realAdExchange/exchange-3_cpm_results.csv,0.5724117801133384,0.9990901715307898,66,1155,0,87,1308
Fixed10,reward_low_FN_rate,realAdExchange/exchange-4_cpm_results.csv,0.5724117801133384,3.8411378254552426,44,1231,2,120,1397
Fixed10,reward_low_FN_rate,realAdExchange/exchange-2_cpm_results.csv,0.5724117801133384,1.9786622238359866,126,1216,3,36,1381
Fixed10,reward_low_FN_rate,artificialNoAnomaly/art_daily_small_noise.csv,0.5724117801133384,0.0,0,3428,0,0,3428
Fixed10,reward_low_FN_rate,artificialNoAnomaly/art_noisy.csv,0.5724117801133384,0.0,0,3428,0,0,3428
Fixed10,reward_low_FN_rate,artificialNoAnomaly/art_flatline.csv,0.5724117801133384,0.0,0,3428,0,0,3428
Fixed10,reward_low_FN_rate,artificialNoAnomaly/art_daily_perfect_square_wave.csv,0.5724117801133384,0.0,0,3428,0,0,3428
Fixed10,reward_low_FN_rate,artificialNoAnomaly/art_daily_no_noise.csv,0.5724117801133384,0.0,0,3428,0,0,3428
Fixed10,reward_low_FN_rate,realTweets/Twitter_volume_AMZN.csv,0.5724117801133384,3.555650767287785,1571,13493,8,9,15081
Fixed10,reward_low_FN_rate,realTweets/Twitter_volume_FB.csv,0.5724117801133384,1.9987878697991823,1576,13499,2,6,15083
Fixed10,reward_low_FN_rate,realTweets/Twitter_volume_UPS.csv,0.5724117801133384,4.955913499996757,957,13528,3,628,15116
Fixed10,reward_low_FN_rate,realTweets/Twitter_volume_CVS.csv,0.5724117801133384,2.9971670778944324,853,13575,2,673,15103
Fixed10,reward_low_FN_rate,realTweets/Twitter_volume_GOOG.csv,0.5724117801133384,2.777104041323113,1422,13655,5,10,15092
Fixed10,reward_low_FN_rate,realTweets/Twitter_volume_AAPL.csv,0.5724117801133384,3.995847413823641,1580,13560,4,8,15152
Fixed10,reward_low_FN_rate,realTweets/Twitter_volume_IBM.csv,0.5724117801133384,1.5587073785337942,1343,13547,6,247,15143
Fixed10,reward_low_FN_rate,realTweets/Twitter_volume_KO.csv,0.5724117801133384,2.558195068837898,1579,13507,7,8,15101
Fixed10,reward_low_FN_rate,realTweets/Twitter_volume_CRM.csv,0.5724117801133384,2.995717085948149,1352,13555,4,241,15152
Fixed10,reward_low_FN_rate,realTweets/Twitter_volume_PFE.csv,0.5724117801133384,3.775144887524125,1217,13514,6,371,15108
Fixed10,reward_low_FN_rate,realKnownCause/cpu_utilization_asg_misconfiguration.csv,0.5724117801133384,0.8896816864921068,1457,15800,1,42,17300
Fixed10,reward_low_FN_rate,realKnownCause/nyc_taxi.csv,0.5724117801133384,4.98930056632332,1023,8530,5,12,9570
Fixed10,reward_low_FN_rate,realKnownCause/ambient_temperature_system_failure.csv,0.5724117801133384,1.997535957073398,716,5789,2,10,6517
Fixed10,reward_low_FN_rate,realKnownCause/ec2_request_latency_system_failure.csv,0.5724117801133384,2.9856209370073703,240,3080,2,106,3428
Fixed10,reward_low_FN_rate,realKnownCause/machine_temperature_system_failure.csv,0.5724117801133384,3.9969760535167183,2258,19673,4,10,21945
Fixed10,reward_low_FN_rate,realKnownCause/rogue_agent_key_updown.csv,0.5724117801133384,1.3477096081574151,22,4031,4,508,4565
Fixed10,reward_low_FN_rate,realKnownCause/rogue_agent_key_hold.csv,0.5724117801133384,1.8745075170475722,183,1406,4,7,1600
Totals,,,,112.10722808492878,27554,299223,124,5941,332842
